{
	"name":"Main Story",
	"description":"The main story for Super Amy!",
	"author":"Lynnear Software",
	"formatVersion":2.5,
	"compressionTable": [
		"nil", "Brick", "Grass", "DirtSurface", "DirtBlock", "CloudB", "CloudA",
		"VictoryGateFG", "VictoryGateBG", "VictoryGateTopFG", "VictoryGateTopBG",
		"VictoryBlock", "Amy", "Slime"
	],
	"acts": [
		{
			"name":"(name of act 1)",
			"levels":[
				{
					"name":"First level!",
					"bgColour": [0.3, 0.8, 1],
					"map": {
						"fg": [
							[[1, 24], 2],
							[[1, 24], 2],
							[[1, 24], 2],
							[[1, 24], 2],
							[[1, 24], 2],
							[[1, 24], 2],
							[[1, 24], 2],
							[[1, 23], 10, 2],
							[2, [1, 22], 8, 2],
							[2, [1, 22], 8, 2],
							[2, 3, 3, 1, 3, 3, 3, 1, 1, 1, 1, 1, 1, 2, 1, 1, 1, 1, 1, 1, 1, 1, 1, 8, 2],
							[4, 4, 4, 1, 4, 4, 4, 2, 2, 2, 2, 2, 2, 2, 2, 2, 2, 2, 2, 2, 2, 2, 2, 4, 2],
							[5, 5, 5, 1, 5, 5, 5, 1, 1, 1, 1, 1, 1, 1, 1, 1, 1, 1, 1, 1, 1, 1, 1, 5, 2],
							[5, 5, 5, 1, 5, 5, 5, 1, 1, 1, 1, 1, 1, 1, 1, 1, 1, 1, 1, 1, 1, 1, 1, 5, 2],
							[5, 5, 5, 1, 5, 5, 5, 1, 1, 1, 1, 1, 1, 1, 1, 1, 1, 1, 1, 1, 1, 1, 1, 5, 2],
							[5, 5, 5, 1, 5, 5, 5, 1, 1, 1, 1, 1, 1, 1, 1, 1, 1, 1, 1, 1, 1, 1, 1, 5, 2]
						],
						"bg": [
							[1, 1, 1, 1, 1, 1, 1, 1, 1, 1, 1, 1, 1, 1, 1, 1, 1, 1, 1, 1, 1, 7, 1, 1, 1],
							[[1, 25]],
							[6, 1, 1, 1, 1, 1, 1, 1, 1, 1, 1, 1, 1, 1, 1, 1, 1, 1, 1, 1, 1, 1, 1, 1, 1],
							[1, 1, 1, 1, 1, 1, 1, 1, 1, 1, 1, 6, 1, 1, 1, 1, 1, 1, 1, 1, 1, 1, 1, 1, 1],
							[1, 1, 1, 1, 1, 1, 1, 1, 1, 1, 1, 1, 1, 1, 1, 1, 7, 1, 1, 1, 1, 7, 1, 1, 1],
							[[1, 25]],
							[1, 1, 6, 1, 1, 1, 1, 1, 1, 7, 1, 1, 1, 1, 1, 1, 1, 1, 1, 1, 1, 1, 1, 1, 1],
							[1, 1, 1, 1, 1, 1, 1, 1, 1, 1, 1, 1, 1, 1, 1, 1, 1, 1, 1, 1, 1, 1, 1, 11, 1],
							[1, 1, 1, 1, 1, 1, 1, 1, 1, 1, 1, 1, 1, 1, 1, 1, 1, 1, 1, 1, 1, 1, 1, 9, 1],
							[1, 1, 1, 1, 1, 1, 1, 1, 1, 1, 1, 1, 1, 1, 1, 1, 1, 1, 1, 1, 1, 1, 1, 9, 1],
							[1, 1, 1, 1, 1, 1, 1, 1, 1, 1, 1, 1, 1, 1, 1, 1, 1, 1, 1, 1, 1, 1, 1, 9, 1],
							[[1, 25]],
							[[1, 25]],
							[[1, 25]],
							[[1, 25]],
							[[1, 25]],
						]
					},
					"obj": [
						[12, 24, 9], [12, 24, 10], [12, 24, 11]
					],
					"ntt": [
						[13, 2.5, 10], [14, 6, 11]
					]
				}
			]
		}
	]
}