{
	"name":"Main Story",
	"description":"The main story for Super Amy!",
	"author":"Lynnear Software",
	"compressionTable": [
		"nil", "Brick", "Grass", "DirtSurface", "DirtBlock", "CloudB", "CloudA"
	],
	"acts": [
		{
			"name":"(name of act 1)",
			"levels":[
				{
					"name":"First level!",
					"bgColour": [0.3, 0.8, 1],
					"map": {
						"fg": [
							[1, 1, 1, 1, 1, 1, 1, 1, 1, 1, 1, 1, 1, 1],
							[1, 1, 1, 1, 1, 1, 1, 1, 1, 1, 1, 1, 1, 1],
							[2, 1, 1, 1, 1, 1, 1, 1, 1, 1, 1, 1, 1, 1],
							[2, 1, 1, 1, 1, 1, 1, 1, 1, 1, 1, 1, 1, 1],
							[2, 3, 3, 1, 3, 3, 3, 0, 1, 1, 1, 1, 1, 2],
							[4, 4, 4, 1, 4, 4, 4, 2, 2, 2, 2, 2, 2, 2],
							[5, 5, 5, 1, 5, 5, 5, 1, 1, 1, 1, 1, 1, 1],
							[5, 5, 5, 1, 5, 5, 5, 1, 1, 1, 1, 1, 1, 1],
							[5, 5, 5, 1, 5, 5, 5, 1, 1, 1, 1, 1, 1, 1],
							[5, 5, 5, 1, 5, 5, 5, 1, 1, 1, 1, 1, 1, 1]
						],
						"bg": [
							[1, 1, 6, 1, 1, 1, 1, 1, 1, 7, 1, 1, 1, 1],
							[1, 1, 1, 1, 1, 1, 1, 1, 1, 1, 1, 1, 1, 1],
							[1, 1, 1, 1, 1, 1, 1, 1, 1, 1, 1, 1, 1, 1],
							[1, 1, 1, 1, 1, 1, 1, 1, 1, 1, 1, 1, 1, 1],
							[1, 1, 1, 1, 1, 1, 1, 1, 1, 1, 1, 1, 1, 1],
							[1, 1, 1, 1, 1, 1, 1, 1, 1, 1, 1, 1, 1, 1],
							[1, 1, 1, 1, 1, 1, 1, 1, 1, 1, 1, 1, 1, 1],
							[1, 1, 1, 1, 1, 1, 1, 1, 1, 1, 1, 1, 1, 1],
							[1, 1, 1, 1, 1, 1, 1, 1, 1, 1, 1, 1, 1, 1],
							[1, 1, 1, 1, 1, 1, 1, 1, 1, 1, 1, 1, 1, 1]
						]
					},
					"obj": [
							["Amy", 2.5, 4], ["Slime", 6, 5]
						]
				}
			]
		}
	]
}